12 x 22
**************O*******
*  R        R        *
*   R *  *  *        *
*  R        *        *
+   **     +   *     *
*   *      *  *      *
*     + *    R  *    *
*  *           *+    O
*     R      *       *
*                    *
*                H   *
********O*************